111111111111111111111111111111111
100200100000000000000000001000001
101011101011111111111111101010111
101010001000001000000010101010001
101010111111101011101010101011101
101000100000101000101000101000101
101111101010101110101110101111101
100010101010100010100010101000101
111010101010111010111011101010101
100010001010001010001000100010001
101111111011111011111110111111101
100010001000100010001010100000101
111010101110101110101010101110101
101000101000101000100013101000101
101111101010101011111110101011101
100000000010100010000000001000001
111111111111111111111111111111111

