111111111111111111111111111111111
100000100000000000100000000000101
101010101111111011101111101110101
101010100000101000101000101000101
101011111110101110101110101110101
101000100010100010100010100210001
111110101010101010111010111011101
100010001010101010000000100010001
101011111010101111111111101111111
101000000010100000001000001000001
101111111010111010111011111011101
100000100010000010100010000010001
101110101111111110101110111110111
101010131000100000100000100010001
101010111010101111111111101111101
100010000010000000000000001000001
111111111111111111111111111111111

