111111111111111111111111111111111
100010003000100010000010001000001
101110111010101011101110101111101
100000101010101010001000100000101
101111101010101010111011111111101
100010001010001000100010000000101
111010101011111110101110111110101
101010101010000010101002100000101
101010101010111011101110101111101
101000101000101010001000100000101
101111101111101010111011111110101
100010100000101000100010001000101
101010111110101111101010101011101
101000001000100000101010101010001
101111111011111010111010101011101
100000000000000010000010100000001
111111111111111111111111111111111

