111111111111111111111111111111111
101000001000000010000010001000001
101010111010111110101010101111101
101010000010000000101000101000101
101011111111111111101111101010101
101000101000001000100000100010001
101110101011101010111110111111101
100010100000100010000010001000001
101110111110111110111011101111111
101000100010101000100010100000001
101011101010101011111010111111101
101000101010001000001000000000101
101110101011111110101111111111101
100010101010000010100000001000001
101010101010111011111111101111111
101020001000100000000000000003001
111111111111111111111111111111111

