111111111111111111111111111111111
101000000000000000001000100002001
101011111010111111101010111110101
101010001010100000101010001000101
101010101011101110101011101011101
101010101000101010100010100010001
101010101110101010111110111110111
101000101000130010100000000000101
101111101011111010111110111111101
100000001000000010000010100000001
101111111111101111111010111011101
101000100000100010001010001010001
111010101110111010101011101010111
100010001010100010101010100010001
101111111010111110101010111111101
100000100000000000100010000000001
111111111111111111111111111111111

