111111111111111111111111111111111
100000100000100000000010000010001
111011101110101110111010111010101
100010001010001010001000101000101
101110111011111011101111101111101
100000120000000010001000100010001
101111111011111010111010111010111
100000000010001010100010001000001
111111111110101010101111101111101
100010000000101010001000100010001
111010111111101011111010101010111
100010100000101010000010101010001
101110101111101110111110111011111
100000101000100010000010001000001
111111101010111011111011101111101
100000000010000000000010000000031
111111111111111111111111111111111

