111111111111111111111111111111111
100000000000001000001000000010001
101111111111111011101010101110101
101000000000000010101010101000101
101011111111111110101110111011101
101010000010000010100010000010101
101010111010111010111011111010101
100010001000101010001020001000101
101110101111101011101111101111101
100010101003100010000000101000101
111010101010101110111111101011101
101010101010001000000000100010001
101011101011111111111010111111101
100010001010000010001010001000101
101110111010111010101110101010101
100000100000100000100000100010001
111111111111111111111111111111111

