111111111111111111111111111111111
101010000000000010000000001000031
101011101111111011111110101011101
100010001000001010000000100010001
101110111011101010111110111111101
100010001000101010100000100000101
111010101010111010101111101110101
101010101010000010101000001010101
101011101011111110111011111010101
101010001000001000000000000010101
101010111111101111111111101110101
101010000000100010000000101000101
101011101110111010111110111011101
101000101000100010001010001010101
101110111011101111101011101010101
100000000010000000001000000012001
111111111111111111111111111111111

