111111111111111111111111111111111
130010000010000000000000100010001
101010111011101111111110101010101
101000101000001000100000101000101
101111101111111110101111101011111
101000001000000000101000001010001
101011101010111110101110101110101
101000100010100010100010100010101
111010101111101011111010111010101
100010101000001000000010001000101
101110111011111111111111101111101
100010100010000000101000001000101
111010101111101010101011111011101
100010101000101010100000000010001
101110101010111010111111111110101
100010000010000010000000000000121
111111111111111111111111111111111

