111111111111111111111111111111111
100000001000100010000000000010001
111110101110101010111111111010101
100000100010101000100000001010101
101111111010101111111011111010111
101000001010100010001010000010001
101010111010111010101010111111101
101010000000001000101210000010001
101111111111111111101011111010111
101000001000100000001000101010001
101011101010111111111010101011101
101000100010001000100010001000001
101110111111101010101011111111101
101000130000100010101000000010001
101011111010111110101111101110111
100000000010000010000000100000001
111111111111111111111111111111111

